2_0;L;2_1;4;9
2_0;E;2_4;9;5
2_0;E;2_2;0;5
2_0;L;2_3;4;0
2_1;L;2_5;9;5
2_1;d;2_11;0;5
2_1;E;2_0;4;0
2_2;E;2_0;9;5
2_2;L;2_7;4;0
2_3;E;2_0;4;9
2_4;L;2_5;4;9
2_4;E;2_0;0;5
2_5;l;2_6;9;5
2_5;d;2_1;0;5
2_5;E;2_4;4;0
2_6;E;2_5;0;5
2_7;E;2_2;8;9
2_7;L;2_9;1;9
2_7;L;2_8;4;0
2_8;E;2_7;4;9
2_9;L;2_10;4;9
2_9;E;2_2;9;5
2_9;E;2_7;8;0
2_10;E;2_11;9;5
2_10;L;2_12;0;5
2_10;E;2_9;4;0
2_11;E;2_1;9;5
2_11;d;2_10;0;5
2_12;E;2_10;9;5
2_12;L;2_13;0;5
2_13;E;2_12;9;5