1_0;d;1_1;5;0
1_1;E;1_0;4;9
1_1;d;1_3;9;4
1_1;L;1_2;5;0
1_2;E;1_1;1;9
1_3;L;1_4;4;9
1_3;l;1_5;4;9
1_3;E;1_1;0;4
1_4;E;1_3;1;0
1_5;D;2_0;9;1
