WWWWWWWWWW
WggggggggW
WgõõõõõõgW
Wg**ããããgW
Wg**DãããgW
Wg**ããããgE
Wg**õõõõgW
WgããããããgW
WggggggggW
WWWWWWWWWW