WôôôôôôôôW
W*(****)*W
Wï*AÈI**ïW
Wï*ç='**ïW
Wï      ïW
WõõõõõõõõW
WËÌÍ*****W
W***ÏÓÖÔÒW
W*]**{*}*W
òòòòòòòòòò
