WWWWWWWWWW
WggggggggW
WgSSSSSSgW
WgS    SgW
WgS    SgW
EgS    SgL
WgS    SgW
WgSSSSSSgW
WggggggggW
WWWWEWWWWW
