***~€‚ƒ***
***„…†‡*a*
ˆŠŠŒŽ‘’ŠŠ•
_**˜™š›**œ
žËÌÍÏÓÖÔÒ³
ž********³
žÉÊ*Ï×ÕÐÕ³
žËÌÍ*****³
·¶¶¶¶¶¶¶¶¸
¹ºººººººº»
