WWWWWWWWWW
WggggggggW
WgTTTTTTgW
WgT    TgW
WgT S  TgW
WgT    TgW
WgT    TgW
WgTTTTTTgW
WggggggggW
WWWWdWWWWW
