WWWWWEWWWW
WS     ggW
W       gW
WWWWWWWW W
d     SW W
W WWWWWW W
WS       W
WgWWWWWWWW
Wgg     SW
WLWWWWWWWW
